FCTB1.00,,,,,,,,,,,
ÐÐ,,,,,,,,,,,
index,col1,col2,col3,col4,col5,col6,col7,col8,col9,col10,col11
1,1,1,1,1,1,1,1,1,1,0,0
2,1,0,0,0,0,0,0,0,3,0,1
3,1,0,3,0,3,1,3,0,3,0,1
4,1,0,3,0,0,0,0,0,3,0,1
5,1,0,3,0,3,1,3,0,3,0,1
6,1,0,3,0,0,0,0,0,0,0,1
7,0,0,1,1,1,1,1,1,1,1,1
